#########################
#P.......##.....#...#...#
#...##.#.#..##..#.#..##..
#...#..#.#..#...##..#....
#...##.##.##.##..##.#..#.
#.....#.....#..#..##..##.
##.#..##..##.#..##.#..##.
#..#.#.....#..#...#..#...
#..##.#..##..##..#..##...
#.....##...##..##..##..##
#..#.#..#..#..#..#..#..#.
#..##..#..##..#..##..#..#
#..#.#..#...#..#.#..#....
#..#..##..#..#..##..#..#.
#..#..###...#......#..#..
#..#...........#.........
#..##...#..##..##..#..##.
#..#..##..#...#..#..#..#.
#..#......##....##..##..#
#..##..###....#......#...
#..#.......##.....##..#..
#..#..#..##..#..##..#..#.
#..#..##..##..##..##..#..
#..#.......#.........#..G
#########################