####################
#P........##...#..##
#..##..#..##.#..#..#
#..#...#..#..#..##.#
#..##..##.##.##....#
#....#....##..#..#.#
#.#.#..##..##.#..###
#..#.#.....#..#...##
#..##.#..##..##..#.#
#.....##...##..##..#
#..#.#..#..#..#..#.#
#..##..#..##..#..###
#..#....#....#..#..#
#..#..###..#..#..#.#
#..#..............##
#..##...#..##..##..#
#..#..##....#..#..##
#..#......##....##.#
#..##...#.....#...G#
####################