###############################
#P.....#..##..#....#...###....#
#.###.#.#..#..###..#...#..##..#
#.#...#.#.#.#....#.#.#.#..#...#
#.#.###.#.#.#..#.#.#.###.##...#
#.#.#...#.#.#..#.#.#...#...#..#
#.#.##.##.#.#.##.#.##..#.##...#
#.#..#....#...#..#..#.###.#...#
#.#..##.#.##.###.#..#.#....#..#
#.#.#.#.#......#.#..#.#.#..#..#
#.##.#.###.####.#.#.##.#.#.#..#
#...#.....#...#.#.#.#..#.#....#
#.#.###..####.#.#.#.#.#.#..#..#
#.#...#..#....#.#.#.#.#.#..#..#
#.####.#..#.##..#.#.#.#.#.#...#
#.#....#..#..#..#...#.#.#.#...#
#.#.#.###.#.#.#.###.##.#.#....#
#.#.#.#...#.#.#.#...#..#.#....#
#.#.#.#.#.##.#.#..#.#..#.#.#..#
#.#.#.#.#.#..#.#..#.#..#.#....#
#.#.#.#.#.#..#.#..#.#..#.#....#
#.#.#.#...#..#.#.#..#..#.#....#
#.#...#.###.#.#.#.#.#..###....#
#.###.#...#.#.#.#.#.#..#......#
#...#.#.#.#.#.#.#.#.#..#.###..#
#.#.#.#.#.#.#.#.#.#.#..#.#....#
#.#.#...#.#...#...#....#.#.#..#
#.#.###.#.#.####.#.###.#.#....#
#.#.....#.#.#..#.#.#...#.#....#
#.##.###..#.#..#.#.#...#.#....#
#.......#........#.....#.....G#
###############################