###############
#P.....#.#....#
#..##..#.#.##.#
#..#...#.#...##
#..##..##..##.#
#....#...#.#..#
##.#.#..##.#..#
#...#.#.....#.#
#.##.#..##..##.
#.#..##....#..#
#.#.......#..#.
#.#..###..#..##
#.#......#.....
#....##.....G..
###############