##########
#P.......#
#..####..#
#..#..#..#
#..#..#..#
#..####..#
#........#
####..##.G
#........#
##########