###############
#P......##....#
#..##..#..##..#
#..#...#...#..#
#..##..##..#..#
#....#...#.#..#
##.#.#..##.#..#
#...#.#.....#.#
#.##.#..##..###
#.#..##....#..#
#.#.......#..#.
#.#..###..#..##
#.#......#....#
#....##.....G.#
###############