##########
#P.......#
#.##.##..#
#..#..#..#
#..##.#..#
#..#..#..#
#.##.##..#
#...#..G.#
#........#
##########