####################
#P##..#..##.#..#..#.
#..#...#..#..#..##.#
#..##..##.##.##....#
#....#....##..#..#..
#.#.#..##..##.#..##.
#..#.#.....#..#...#.
#..##.#..##..##..#..
#.....##...##..##..#
#..#.#..#..#..#..#..
#..##..#..##..#..##.
#..#....#....#..#...
#..#..###..#..#..#..
#..#..............#.
#..##...#..##..##..#
#..#..##....#..#..#.
#..#......##....##..
#..##...#.....#....#
#..#.......##.....G.
####################