###############
#P....#.......#
#....##.##....#
#....#...#....#
##...##..##...#
#.....#...#...#
#..##.#.#.#...#
#...#.#.#.#...#
#...#...#...#.#
#...###.#.##..#
#...#......#..#
#...#.##..##..#
#.............#
#.........#..G#
###############