##########
#P##...#.#
#..#.#.#.#
#..#.#.#.#
#..###.#.#
#..#...#.#
#..##.#.#.
#....G#..#
#........#
##########