####################
#P.......#.........#
#..##....##....##..#
#..#...#...#..#..#..
#..##..##..#..##.##.
#....#....##..#..#..
#.#.#..##..##.#..##.
#..#.#.....#..#...#.
#..##.#..##..##..#..
#.....##...##..##..#
#..#.#..#..#..#..#..
#..##..#..##..#..##.
#..#....#....#..#...
#..#..###..#..#..#..
#..#..............#.
#..##...#..##..##..#
#..#..##....#..#..#.
#..##.....##....##..
#..##...#.....#....G
####################