###############
#P....#...#...#
##..#.#.#.#.#.#
#...##..#.#...#
#...#.....#...#
#...#...##..#.#
#...##..##..#..
#.....##...##.#
#..#.#..#..#..#
#..#...#..##..#
#...#....#....#
#...#..###..#..
#...#........##
#...##...#..G.#
###############