###############################
#P....##...###....##..#...#...#
#..##..#..#...##...#..##.##..##
#.###.##..##..#..###.#...#....#
#.#.....##...###.#....###.#...#
#.#..####..##....#.##..#..#...#
#.#..#..#..#...#..#..####.##..#
#.#.##.##.##..#.#..#..#....#..#
#.#..#......#.#.#..##.#..#.#..#
#.##..####.#.#.#.##..##..#.#..#
#....#....#.#.#.#...##...#.#..#
#####.#..#.#.#.##.###..#.#.#..#
#...#.##.#.#.#..#......#.#....#
#.#...##.#.#.##.#.####.#.#.#.##
#.#.#..#.#.#.#...#....#.#....##
#.#.#..##..#.####..####.##.#..#
#.#...#..#.#....#.#..#..#..#..#
#.#.##.##..#.##.#.#..#.##.##..#
#.#..#..#.##.#..#.##.#...#....#
#.#..##.....#.#...#..####.#...#
#.#...###.#.#.#.#.#......#....#
#.###.#...#.#.###.#..##.#.#...#
#...#.##..#.#..#..#.#..#.#.#..#
#.#...#...#.##.#.##.##.#.#.#..#
#.##.##.##.#..#..#....#.#....##
#..#..#.#..##.###..##.#.###...#
#.#.##.#.#.#....#.#..#.#......#
#.#....#..#..##.#.#..#.#.##...#
#.##.#....#..#..#.#..#.#.#....#
#.....##...#.....##...#......G#
###############################