###############################
#P....##....##....##..#...#...#
#..##..#..#...##...#..##.##..##
#.###.##..##.....###.#...#....#
#.##.....#...###......###.#...#
#.##.####..##....#.##.....#...#
#.#..#..#..##.##..#######.##..#
#.#.##.##.###.#.#.##..#....#..#
#.#..#......#.#.#.###.#..#.#..#
#.##..####.###.#.##..##..#.#..#
#.........###.#.#...##...#.#..#
#####.##.#.#.#.##.###..#.#.#..#
#...#.##.#.#.#..#......#.#....#
#.#...##.#.#.##.#.####.#.#.#.##
#.#.#..#.#.#.#...#....#.#....##
#.#.#..##..#.####..####.##.#..#
#.#...#..#.#....#.#..#..#..#..#
#.#.##.##..#.##.#.#..#.##.##..#
#.#..#..#.##.#..#.##.#...#....#
#.#..##.....#.#...#..####.#...#
#.#...###.#.#.#.#.#......#....#
#.###.#...#.#.###.#..##.#.#...#
#...#.##..#.#..#..#.#..#.#.#..#
#.#...#...#.##.#.##.##.#.#.#..#
#.##.##.##.#..#..#....#.#....##
#..#..#.#..##.###..##.#.###...#
#.#.##.#.#.#....#.#..#.#......#
#.#....#..#..##.#.#..#.#.##...#
#.##.#....#..#..#.#..#.#.#....#
#.....##...#.....##...#......G#
###############################