##########
#P...#...#
#..##..#.#
#..#...#.#
#..##..#.#
#..#...#.#
#..##..#.#
#...#...G#
#........#
##########